wwwwwwwwwwwwwww
w...T.....T...w
w.......A.....w
w.............w
wT...........Tw
w......T......w
w.....P.P.....w
wP..T..X..T..Pw
w.....P.P.....w
w......T......w
wT...........Tw
w.............w
w.....B.......w
w...T.....T...w
wwwwwwwwwwwwwww
