wwwwwwwwwww
w..*.*.*.pw
w.A..**...w
w...lu..*.w
w.*.www...w
w.*.wgw..*w
w.*.www...w
w....dr...w
w..**.*.B.w
wp.*.*..*.w
wwwwwwwwwww